111111111111111111111
1C0000CCCC000000000C1
1E0000CCCC001000000C1
100010100001C101C0011
1P0010100000100CCCC01
111111111111111111111