111111111111111111111
100000CCCC000000000C1
1E00101000000001C0011
1P0010100000000CCCC01
111111111111111111111