111111111111111111111
1C0000CCCC000000000C1
1E0000CCCC000000000C1
1000101000000001C0011
1P0010100000000CCCC01
111111111111111111111